 ________________ 
|                |
|                |
|                |
|                |
| fin limitation |
|   de vitesse   |
|                |
|                |
|                |
|________________|